61 61
59 60
XXXXXXXXXXXXXXXXXXXXXXXXXXXXXXXXXXXXXXXXXXXXXXXXXXXXXXXXXXXXX
X   X     X       X         X   X       X           X X X   X
X X X X XXX XXX XXXXXXX XXX XXX XXX XXX XXX XXXXXXXXX X X XXX
X X X X X   X   X     X   X     X X   X X                 X X
X XXX X XXXXX XXX XXX XXX X XXX X X XXX X XXXXX X X X XXXXX X
X     X     X   X   X     X X   X   X       X X X X X   X   X
XXX XXXXXXX X XXXXXXXXX XXX XXXXX X X X XXX X X XXXXX XXX X X
X       X           X     X X     X X X X   X     X X     X X
XXX XXX XXX X X XXXXXXXXXXX X XXXXX XXXXXXX XXXXXXX X XXXXXXX
X     X X X X X   X   X     X     X     X   X     X X X     X
X X XXXXX XXX X X XXX XXX XXX XXX X XXXXX X XXX X X XXXXX X X
X X   X   X X X X     X X X     X X   X   X X   X X       X X
XXXXXXX XXX X XXXXXXX X X XXX XXXXXXXXX XXX XXX X X XXXXXXX X
X X X   X X X     X   X   X X       X     X   X X X X       X
X X X X X X X XXXXX XXXXX X XXXXXXXXXXXXXXX XXXXX XXX XXX XXX
X   X X           X             X X       X     X     X     X
X XXXXXXXXXXX XXXXXXXXX X X X XXX XXX X X X XXX X XXXXXXXXXXX
X         X     X X X X X X X     X   X X     X       X X   X
X XXXXXXXXXXXXXXX X X XXX X XXXXXXXXX X XXX XXXXX XXXXX X XXX
X   X   X           X     X   X       X   X X X   X       X X
X XXXXX XXX X XXX XXXXXXXXX X X XXXXX XXXXXXX XXX X XXX XXX X
X   X       X   X X X       X X   X X     X X X   X X       X
XXX XXXXX XXXXXXXXX X XXX X XXXXX X X XXX X X XXX XXX X XXX X
X   X X         X     X X X X     X   X X X X     X   X X   X
XXX X X X X XXX XXX X X XXXXXXXXXXX XXX X X X XXXXX XXXXX X X
X   X X X X X X X   X X     X X X X     X X X X   X X X   X X
X XXX X X XXX XXX XXX X XXXXX X X XXXXX XXX XXXXX XXX XXX X X
X   X X X X X     X     X   X   X   X X X   X       X X X X X
XXX X XXX X XXXXXXX XXXXXXX XXX X XXX X X X XXX XXXXX X X XXX
X X   X     X   X     X       X       X   X           X X   X
X XXX XXX X X XXXXXXX XXX XXXXXXXXXXX X XXX XXXXXXX X X X X X
X       X X       X   X         X       X   X X   X X X   X X
X X XXXXXXX XXXXX X X XXX XXXXXXXXX XXXXXXX X X X XXXXX XXXXX
X X     X   X X     X   X   X X X   X   X     X X X X X   X X
X XXX XXXXX X XXX X X X XXX X X XXX XXX X XXXXXXX X X XXX X X
X   X       X     X X X   X   X         X     X     X X X X X
X XXX XXX XXXXX XXXXXXXXX XXX X XXX X XXXXX XXXXXXX X X X X X
X   X X       X   X X X       X   X X X   X X X       X   X X
X XXX XXXXXXX XXXXX X X X X XXXXX XXXXX X XXX X XXXXXXXXX X X
X X       X X X       X X X X   X   X X X                   X
X X X X XXX XXX XXXXX X X XXX XXX X X XXXXX XXX X XXXXX XXX X
X X X X X       X       X         X X     X   X X X X   X   X
XXXXX XXXXXXX XXXXXXXXXXX XXX XXXXXXXXX XXXXX X XXX XXX XXX X
X X X X       X X X   X   X   X   X     X     X X X X X   X X
X X X XXXXXXX X X X XXXXX XXXXXXX X XXX X XXX XXX X X XXXXXXX
X     X     X X   X X       X X X   X       X     X X     X X
XXX XXX XXX XXX XXX XXXXX X X X XXXXX X X X XXXXXXX XXX X X X
X   X   X   X       X X   X X   X X   X X X X     X     X X X
XXX XXXXX XXX XXXXX X XXXXX X XXX XXXXXXX XXXXX X XXX XXX X X
X   X   X X   X         X       X X   X   X   X X X     X   X
XXX X X X X XXXXXXX X XXXXX XXX X X XXX XXX XXX XXXXX X XXX X
X X X X X X   X   X X   X X X X       X   X X     X   X X X X
X XXX X X XXXXXXX XXX X X XXX XXX XXX XXX X XXXXX XXX XXX XXX
X     X       X       X     X   X X   X   X X   X X         X
XXX XXX XXXXXXX XXX X XXXXXXXXX X X X X XXX X X X XXXXX XXXXX
X X   X   X       X X           X X X       X X           X X
X XXXXX XXX X XXX XXX X X XXX X X XXX X X XXX X X XXX XXXXX X
X   X   X   X X   X   X X X   X   X X X X     X X X     X   X
X XXX XXX XXXXXXX XXX X XXX X XXX X XXX XXXXXXXXX XXXXX X XXX
X           X       X X X   X   X     X         X X          
XXXXXXXXXXXXXXXXXXXXXXXXXXXXXXXXXXXXXXXXXXXXXXXXXXXXXXXXXXXXX